36 27
100 000 000 000 000 000 000 000 000 000 000 000 000 000 000 000 000 000 000 000 000 000 000 000 000 000 000 000 000 000 000 000 000 000 000 100
100 000 000 000 000 000 000 000 000 000 000 000 000 000 000 000 000 000 000 000 000 000 000 000 000 000 000 000 000 000 000 000 000 000 000 100
100 000 000 000 000 000 000 000 000 000 000 000 000 000 000 000 000 000 000 000 000 000 000 000 000 000 000 000 000 000 000 000 000 000 000 100
100 000 000 000 000 000 000 000 000 000 000 000 000 000 000 000 000 000 000 000 000 000 000 100 100 000 000 000 000 000 000 000 000 000 000 100
100 000 000 000 000 000 000 000 000 000 000 000 000 000 000 000 000 000 000 000 000 000 000 100 100 000 000 000 000 000 000 000 000 000 000 100
100 000 000 000 100 100 100 000 000 000 000 000 000 000 000 000 000 000 000 000 000 000 000 100 100 000 000 000 000 000 000 000 000 000 000 100
100 000 000 000 000 000 000 000 000 000 000 000 000 000 000 100 000 000 000 000 000 000 000 100 100 100 000 000 000 000 000 000 000 000 000 100
100 000 000 000 000 000 000 000 000 000 000 000 000 446 000 100 000 100 000 000 000 000 000 100 100 100 000 000 000 000 000 000 000 000 000 100
100 000 820 000 000 000 000 000 000 000 000 100 000 100 000 100 000 100 000 100 000 000 000 000 000 000 000 000 000 449 000 000 000 000 000 100
100 100 100 100 100 100 100 100 100 100 100 100 100 100 100 100 100 100 100 100 100 100 100 100 100 100 100 100 100 100 300 300 000 300 300 100
100 000 000 000 000 000 000 000 000 000 000 000 000 000 000 000 000 000 000 000 000 000 000 000 000 000 000 000 000 100 100 100 000 100 100 100
100 000 000 000 000 000 000 000 000 000 000 000 000 000 000 000 000 000 000 000 000 000 000 000 000 000 000 000 000 100 000 000 000 000 000 100
100 000 000 000 000 000 000 000 000 000 000 000 000 000 000 000 000 000 000 000 000 000 000 000 000 000 000 000 000 100 000 000 000 000 000 100
100 000 000 000 000 000 000 000 000 000 000 000 000 000 000 000 000 000 000 000 000 000 000 000 000 000 000 000 000 100 300 300 300 000 300 100
100 000 000 000 000 000 000 000 000 000 000 000 000 000 000 000 000 000 000 000 000 000 000 000 000 000 000 000 000 100 100 100 100 000 100 100
100 000 000 000 000 000 000 000 000 000 000 000 000 000 000 000 000 000 000 000 000 000 000 000 000 000 000 000 000 100 000 000 000 000 000 100
100 000 000 000 000 000 000 000 000 000 000 000 000 000 000 000 000 000 000 000 000 000 000 000 000 000 000 000 000 100 000 000 000 000 000 100
100 000 000 000 000 000 000 000 000 000 000 000 000 000 000 000 000 000 000 000 000 000 000 000 000 000 000 000 000 100 300 300 000 300 300 100
100 000 000 000 000 000 100 100 100 100 100 100 100 100 100 100 100 100 100 100 100 100 100 100 100 100 100 100 100 100 100 100 000 100 100 100
100 100 100 000 000 000 000 000 000 000 000 000 000 000 000 000 000 000 000 000 000 000 000 000 000 000 000 000 000 000 100 000 000 000 000 100
100 000 000 000 000 000 000 000 000 000 000 000 000 000 000 000 000 000 000 000 000 000 000 000 000 000 000 000 000 000 100 000 000 000 000 100
425 000 000 000 000 000 000 000 000 000 000 000 000 000 000 000 000 000 000 000 000 000 000 000 000 000 000 000 000 000 100 000 000 000 000 100
100 000 000 000 000 100 100 100 000 000 000 000 000 000 000 100 100 100 000 000 000 000 000 000 000 100 100 100 000 000 000 000 000 000 000 100
100 000 000 000 000 000 000 000 000 000 000 000 000 000 000 000 000 000 000 000 000 000 000 000 000 000 000 000 000 000 000 000 000 000 000 100
429 000 000 000 000 000 000 000 000 000 000 000 000 000 000 000 000 000 000 000 000 000 000 000 000 000 000 000 000 100 000 000 000 000 000 100
100 300 300 300 300 300 300 300 300 300 100 100 100 300 300 300 300 300 300 300 100 100 100 300 300 300 300 300 300 100 100 100 100 100 100 100
100 100 100 100 100 100 100 100 100 100 100 100 100 100 100 100 100 100 100 100 100 100 100 100 100 100 100 100 100 100 100 100 100 100 100 100 