36 27 90
100 000 000 000 000 000 000 000 000 000 000 000 000 000 000 000 000 000 000 000 000 000 000 000 000 000 000 000 000 000 000 000 000 000 000 100
100 000 000 000 000 000 000 000 000 000 000 000 000 000 000 000 000 000 000 000 000 000 000 000 000 000 000 000 000 000 000 000 000 000 000 100
100 000 000 000 000 000 000 000 000 000 000 000 000 000 000 000 000 000 000 000 000 000 000 000 810 000 000 000 000 000 000 000 000 000 000 100
100 000 000 000 000 000 000 000 000 000 000 000 000 000 000 000 000 000 000 000 000 000 000 100 100 000 000 000 000 000 000 000 000 000 000 100
100 000 000 000 000 000 000 000 000 000 000 000 000 000 000 000 000 000 000 000 000 000 000 100 100 000 000 000 000 000 000 000 000 000 000 100
100 000 000 000 100 100 100 000 000 000 000 000 000 000 000 000 000 000 000 000 000 000 000 100 100 000 000 000 000 000 000 000 000 000 000 100
100 000 000 000 000 000 000 000 000 000 000 000 000 000 000 100 000 000 000 000 000 000 000 100 100 100 000 000 000 000 000 000 000 000 000 100
100 000 000 000 000 000 000 000 000 000 000 000 000 446 000 100 000 100 000 000 000 000 000 100 100 100 000 000 000 000 000 000 000 000 000 100
100 000 820 000 000 000 000 000 000 000 000 100 000 100 000 100 000 100 000 100 000 000 000 000 000 000 000 000 000 449 000 000 000 000 000 100
100 100 100 100 100 100 100 100 100 100 100 100 100 100 100 100 100 100 100 100 100 100 100 100 100 100 100 100 100 100 300 300 000 300 300 100
100 000 000 000 000 000 000 000 000 000 000 000 000 000 000 000 000 000 000 000 000 000 000 000 000 000 000 000 000 100 100 100 000 100 100 100
100 000 000 000 000 000 000 000 000 000 000 000 000 000 000 000 000 000 000 000 000 000 000 000 000 000 000 000 000 100 000 000 000 000 000 100
100 000 000 000 000 000 100 000 000 000 000 000 000 000 000 000 522 000 000 000 000 000 000 000 000 100 000 000 000 100 000 000 000 000 000 100
100 000 000 000 000 000 000 000 000 000 000 000 000 000 000 000 000 000 000 000 000 000 000 000 000 000 000 000 000 100 000 810 000 000 000 100
100 000 000 000 000 000 000 000 000 000 000 000 000 000 000 000 000 000 000 000 000 000 000 000 000 000 000 000 000 100 000 000 000 000 000 100
100 000 000 000 000 000 300 300 300 300 300 300 300 300 300 300 300 300 300 300 300 300 300 300 300 300 000 830 000 100 000 000 000 000 000 100
100 000 000 000 000 000 100 100 100 100 100 100 100 100 100 100 100 100 100 100 100 100 100 100 100 100 100 100 100 100 000 000 000 000 000 100
100 000 000 000 000 000 000 000 000 000 000 000 000 000 000 000 000 000 000 000 000 000 000 000 000 000 000 000 000 100 300 300 300 300 000 100
100 100 100 000 000 000 000 000 000 000 000 000 000 000 000 000 000 000 000 000 000 000 000 000 000 000 000 000 000 100 100 100 100 100 000 100
100 000 000 000 000 000 000 000 000 000 000 000 000 000 000 000 000 000 000 000 000 000 000 000 000 000 000 000 000 000 100 000 000 000 000 100
427 000 000 000 000 000 000 000 000 000 000 000 000 000 000 000 000 000 000 000 000 000 000 000 000 000 000 000 000 000 100 000 000 000 000 100
100 000 000 000 000 100 100 100 000 000 000 000 000 000 000 100 100 100 000 000 000 000 000 000 000 100 100 100 000 000 100 000 000 000 000 100
100 810 000 000 000 000 000 000 000 000 000 000 000 000 000 000 000 000 000 000 000 000 000 000 000 000 000 000 000 000 000 000 000 000 000 100
100 100 100 000 000 000 000 000 000 000 000 000 000 000 000 000 000 000 000 000 000 000 000 000 000 000 000 000 000 000 000 000 000 000 000 100
429 000 000 000 000 000 000 000 000 000 000 000 000 000 000 000 000 000 000 000 000 000 000 000 000 000 000 000 000 100 000 000 000 000 000 100
100 300 300 300 300 300 300 300 300 300 100 100 100 300 300 300 300 300 300 300 100 100 100 300 300 300 300 300 300 100 100 100 100 100 100 100
100 100 100 100 100 100 100 100 100 100 100 100 100 100 100 100 100 100 100 100 100 100 100 100 100 100 100 100 100 100 100 100 100 100 100 100 