20 16
000 000 000 000 000 000 000 000 000 000 000 000 000 000 000 000 000 000 000 000
000 000 000 000 000 000 000 000 000 000 000 000 000 000 000 000 000 000 000 000
000 000 000 000 000 000 000 000 000 000 000 000 000 000 000 000 000 000 000 000
000 000 000 000 100 100 000 000 000 000 000 000 000 000 000 000 000 000 000 000
000 000 000 100 100 100 100 000 000 000 000 000 000 000 000 000 000 000 000 000
900 000 100 100 100 100 100 100 000 000 000 000 000 000 000 000 000 000 000 000
100 100 100 100 100 100 100 100 100 100 100 100 100 100 100 100 100 100 000 000
000 000 000 000 000 000 000 000 000 000 000 000 000 000 000 000 000 000 000 000
000 000 000 000 000 000 000 000 000 000 000 000 000 000 000 000 000 000 000 000
000 000 000 000 000 000 000 000 000 000 000 000 000 000 000 000 000 000 000 000
000 000 000 000 000 000 000 000 000 000 000 000 000 000 000 000 000 000 000 000
000 000 000 000 000 000 000 000 000 000 000 000 000 000 000 000 000 000 000 000
000 000 000 000 000 000 000 000 100 100 100 000 000 000 000 100 100 100 100 100
000 000 000 000 000 000 000 100 100 100 100 000 000 000 000 100 100 100 100 100
100 100 300 300 100 100 100 100 100 100 100 300 300 300 300 100 100 100 100 100
100 100 100 100 100 100 100 100 100 100 100 100 100 100 100 100 100 100 100 100