37 37 90
000 000 000 000 000 000 000 000 000 000 000 000 000 100 000 000 000 000 000 000 000 000 000 000 000 000 000 000 000 000 000 000 000 000 000 000 000
000 000 000 000 000 000 000 000 000 000 000 000 000 100 000 000 000 000 000 000 000 000 000 000 000 000 000 000 000 000 000 000 000 000 000 000 000
000 000 000 000 000 000 000 000 000 000 000 000 000 100 000 000 000 000 000 000 000 000 000 000 000 000 000 000 000 000 000 000 000 000 000 000 000
000 000 000 000 000 000 000 000 000 000 000 000 000 100 000 000 000 000 000 000 000 000 000 000 000 000 000 000 000 000 000 000 000 000 000 000 000
000 820 000 000 000 000 000 000 000 000 000 000 000 100 000 830 000 000 000 000 000 000 000 000 000 000 000 000 000 000 000 000 000 000 000 000 000
100 100 100 100 100 100 100 100 000 000 000 000 000 100 100 100 100 100 100 100 100 100 100 100 100 100 100 100 100 100 100 100 100 100 000 000 000
000 000 000 000 000 000 000 100 000 000 000 000 000 100 000 000 000 000 000 000 000 000 000 000 000 000 000 000 000 000 000 000 000 000 000 000 000
000 000 000 000 000 000 000 100 000 000 000 000 000 100 000 000 000 000 000 000 000 000 000 000 000 000 000 000 000 000 000 000 000 000 000 000 000
000 000 000 000 000 000 000 100 300 300 000 300 300 100 000 000 000 000 000 000 000 000 000 000 000 000 000 000 000 000 000 000 000 000 000 000 000
000 000 000 000 000 000 000 100 100 100 000 100 100 100 000 000 000 000 000 000 000 000 000 000 000 000 000 000 000 000 000 000 000 000 000 000 000
000 000 000 000 000 000 000 100 000 000 000 000 000 100 000 000 000 000 000 000 000 000 000 000 000 000 000 000 000 000 000 000 000 000 000 000 000
000 000 000 000 000 000 000 100 000 000 000 000 000 100 000 000 100 100 100 100 100 320 000 100 100 100 000 000 000 000 000 000 330 100 100 100 100
000 000 000 000 000 000 000 100 000 000 000 000 000 100 000 000 000 000 000 100 100 320 000 000 000 000 000 000 000 000 000 000 330 100 100 100 100
000 000 000 000 000 000 000 100 000 000 000 000 000 100 000 000 000 000 000 100 100 429 000 000 000 000 000 000 000 000 000 000 330 100 100 100 100
000 000 000 000 000 000 000 100 000 000 000 000 000 100 000 000 000 000 000 100 100 320 000 000 000 000 000 000 000 000 000 000 330 100 100 100 100
000 000 000 000 000 000 000 100 000 000 000 000 000 100 000 000 000 000 000 100 100 320 000 000 000 000 000 000 000 000 000 000 330 100 100 100 100
000 000 000 000 000 000 000 100 300 300 300 300 000 100 000 300 000 000 000 100 100 320 000 000 000 000 000 000 000 000 000 000 330 100 100 100 100
000 000 000 000 000 000 000 100 100 100 100 100 000 100 100 100 100 000 000 100 100 320 000 000 000 000 000 000 000 000 000 000 330 100 100 100 100
000 000 000 000 000 000 000 100 000 000 000 000 000 100 000 000 000 000 000 100 100 320 000 000 000 000 000 000 000 000 000 000 449 100 100 100 100
000 000 000 000 000 000 000 100 000 000 000 000 000 100 000 000 000 000 000 100 100 320 000 000 000 000 000 000 000 000 000 000 330 100 100 100 100
000 000 000 000 000 000 000 100 000 000 000 000 000 100 000 000 000 000 000 100 100 320 000 000 000 000 000 000 000 000 000 000 330 100 100 100 100
000 000 000 000 000 000 000 100 000 000 000 000 000 100 000 000 000 000 000 100 100 429 000 000 000 000 000 000 000 000 000 000 330 100 100 100 100
000 000 000 000 000 000 000 100 000 000 000 000 000 100 000 000 000 300 000 100 100 320 000 000 000 000 000 000 000 000 000 000 330 100 100 100 100
000 000 000 000 000 000 000 100 000 000 000 000 000 100 000 000 100 100 100 100 100 320 000 000 000 000 000 000 000 000 000 000 330 100 100 100 100
000 000 000 000 000 000 000 100 000 300 300 300 300 100 000 000 000 000 000 100 100 320 000 000 000 000 000 000 000 000 000 000 330 100 100 100 100
000 000 000 000 000 000 000 100 000 100 100 100 100 100 000 000 000 000 000 100 100 320 000 000 000 000 000 000 000 000 000 000 330 100 100 100 100
000 000 000 000 000 000 000 100 000 000 000 000 000 100 000 000 000 000 000 100 100 320 000 000 000 000 000 000 000 000 000 000 449 100 100 100 100
000 000 000 000 000 000 000 100 000 000 000 000 000 100 000 000 000 000 000 100 100 320 000 000 000 000 000 000 000 000 000 000 330 100 100 100 100
000 000 000 000 000 000 000 100 000 000 000 000 000 100 000 300 000 000 000 100 100 320 000 000 000 000 000 000 000 000 000 000 330 100 100 100 100
000 000 000 000 000 000 000 100 000 000 000 000 000 100 100 100 100 000 000 100 100 429 000 000 000 000 000 000 000 000 000 000 330 100 100 100 100
000 000 000 000 000 000 000 100 000 000 000 000 000 000 000 000 000 000 000 100 100 320 000 000 000 000 000 000 000 000 000 000 330 100 100 100 100
000 000 000 000 000 000 000 100 000 000 000 000 000 000 000 000 000 000 000 100 100 320 000 000 000 000 000 000 000 000 000 000 330 100 100 100 100
000 000 000 000 000 000 000 100 000 000 000 000 000 000 000 000 000 000 000 100 100 320 000 000 000 000 000 000 000 000 000 000 330 100 100 100 100
000 000 000 000 000 000 000 100 000 000 000 000 000 000 000 000 000 000 000 100 100 320 000 000 000 000 000 000 100 100 100 000 330 100 100 100 100
000 000 000 000 000 000 000 100 100 000 000 000 000 000 000 000 000 000 000 100 100 320 000 000 000 000 000 000 000 000 000 000 330 100 100 100 100
000 000 000 000 000 000 000 100 300 300 300 300 300 300 000 000 000 000 000 100 100 300 300 300 300 300 300 300 300 300 300 300 300 100 100 100 100
100 100 100 100 100 100 100 100 100 100 100 100 100 100 100 100 100 100 100 100 100 100 100 100 100 100 100 100 100 100 100 100 100 100 100 100 100